2, 2, 2, 2, 2, 2, 2, 2, 2, 2, 2, 2, 2, 2, 2, 2, 2, 2, 2, 2,
2, 2, 2, 3, 3, 3, 3, 3, 3, 3, 3, 3, 3, 3, 3, 3, 3, 3, 3, 2,
2, 3, 3, 3, 3, 3, 3, 3, 3, 3, 3, 3, 3, 3, 3, 3, 3, 3, 3, 2,
2, 3, 3, 3, 3, 7, 7, 7, 7, 7, 7, 7, 7, 7, 7, 3, 3, 3, 3, 2,
2, 3, 3, 3, 3, 7, 7, 5, 5, 5, 5, 5, 5, 7, 7, 3, 3, 3, 3, 2,
2, 3, 3, 3, 3, 7, 7, 7, 5, 5, 5, 5, 7, 7, 7, 3, 3, 3, 3, 2,
2, 3, 3, 3, 3, 7, 7, 5, 5, 5, 5, 5, 5, 7, 7, 3, 3, 3, 3, 2,
2, 3, 3, 3, 3, 7, 7, 7, 7, 7, 7, 7, 7, 7, 7, 3, 3, 3, 3, 2,
2, 3, 3, 3, 3, 3, 3, 3, 3, 3, 3, 3, 3, 3, 3, 3, 3, 3, 3, 2,
2, 3, 3, 3, 3, 3, 3, 3, 3, 3, 3, 3, 3, 3, 3, 3, 3, 2, 2, 2,
2, 3, 3, 3, 3, 3, 3, 3, 3, 3, 3, 3, 3, 3, 3, 3, 3, 2, 2, 2,
2, 2, 2, 2, 2, 2, 2, 2, 2, 2, 2, 2, 2, 2, 2, 2, 2, 2, 2, 2