981, 701, 699, 699, 699, 699, 699, 699, 702, 981, 981, 981, 981, 981, 981, 981, 981, 981, 701, 699,
981, 757, 874, 874, 874, 874, 874, 874, 758, 699, 699, 699, 699, 699, 699, 699, 699, 699, 759, 874,
981, 757, 869, 869, 869, 869, 869, 869, 873, 874, 874, 874, 874, 874, 874, 874, 874, 874, 875, 869,
981, 757, 10, 10, 10, 10, 10, 10, 870, 869, 869, 869, 869, 869, 869, 869, 869, 869, 872, 10,
981, 757, 10, 10, 10, 10, 10, 10, 120, 120, 120, 120, 120, 120, 120, 120, 120, 120, 120, 10,
981, 757, 10, 10, 10, 10, 10, 10, 120, 120, 120, 120, 120, 120, 120, 120, 120, 120, 120, 10,
981, 758, 699, 699, 699, 699, 699, 699, 702, 120, 120, 923, 924, 924, 924, 925, 120, 120, 120, 701,
981, 1272, 1273, 1273, 1273, 1273, 1273, 1273, 757, 120, 120, 980, 981, 981, 981, 982, 120, 120, 120, 757,
981, 1329, 1330, 1330, 1330, 1330, 1330, 1330, 757, 120, 120, 1037, 1038, 1038, 1038, 1039, 120, 120, 120, 757,
981, 981, 981, 981, 981, 981, 981, 981, 757, 120, 120, 120, 120, 120, 120, 120, 120, 120, 120, 757,
981, 981, 981, 981, 981, 981, 981, 981, 757, 120, 120, 120, 120, 120, 120, 120, 120, 120, 120, 757,
981, 981, 981, 981, 981, 981, 981, 981, 757, 120, 120, 120, 120, 120, 120, 120, 120, 120, 120, 757