0, 0, 0, 0, 0, 0, 0, 0, 0, 0, 0, 0, 0, 0, 0, 0, 0, 0, 0, 0,
0, 0, 312, 0, 202, 0, 0, 0, 0, 0, 0, 0, 0, 0, 0, 0, 0, 0, 0, 0,
0, 0, 369, 0, 259, 0, 0, 0, 0, 160, 0, 160, 0, 160, 0, 160, 0, 160, 0, 0,
0, 0, 130, 0, 0, 0, 0, 0, 0, 217, 0, 217, 0, 217, 0, 217, 0, 217, 0, 0,
0, 0, 0, 0, 0, 0, 0, 0, 0, 0, 0, 0, 0, 0, 0, 0, 0, 0, 0, 0,
0, 0, 130, 0, 0, 0, 0, 0, 0, 0, 0, 0, 0, 0, 0, 0, 0, 0, 0, 0,
0, 0, 0, 0, 0, 0, 0, 0, 0, 0, 0, 0, 191, 191, 191, 0, 0, 0, 0, 0,
0, 0, 159, 0, 0, 0, 159, 0, 0, 0, 0, 0, 255, 256, 370, 0, 0, 0, 0, 0,
0, 0, 216, 0, 0, 0, 216, 0, 0, 0, 0, 0, 306, 306, 306, 0, 0, 0, 0, 0,
0, 0, 0, 0, 0, 0, 0, 0, 0, 0, 0, 0, 0, 0, 0, 0, 0, 0, 0, 0,
0, 0, 0, 0, 0, 0, 586, 0, 0, 0, 0, 0, 0, 0, 0, 0, 0, 0, 0, 0,
0, 0, 0, 0, 0, 0, 643, 0, 0, 0, 0, 0, 0, 0, 0, 0, 0, 0, 0, 0